-1,32,107,-1,124,107,-1,124,107,-1,124,107,-1,124,107,-1,124,107,-1,124,107,-1,124,107,-1,124,107,-1,124,107,-1,124,107,-1,124,107,-1,124,107,-1,124,107,-1,124,107,-1,124,107,-1,124,107,-1,124,107,-1,124,107,-1,124,107,-1,124,107,-1,124,-1,-1,-1,-1,-1
-1,87,87,123,-1,140,123,-1,140,123,-1,140,123,-1,140,123,-1,140,123,-1,140,123,-1,140,123,-1,140,123,-1,140,123,-1,140,123,-1,140,123,-1,140,123,-1,140,123,-1,140,123,-1,140,123,-1,140,123,-1,140,123,-1,140,123,-1,140,123,-1,140,123,-1,140,-1,110,-1,-1
106,87,-1,-1,-1,-1,-1,-1,-1,-1,-1,-1,-1,-1,-1,-1,-1,-1,-1,-1,-1,-1,-1,-1,-1,-1,-1,-1,-1,-1,-1,-1,-1,-1,-1,-1,-1,-1,-1,-1,-1,-1,-1,-1,-1,-1,-1,-1,-1,-1,-1,-1,-1,-1,-1,-1,-1,-1,-1,-1,-1,-1,-1,-1,-1,-1,-1,-1,126,-1
-1,122,-1,-1,451,-1,468,-1,-1,-1,-1,377,-1,-1,-1,356,-1,373,-1,-1,-1,-1,-1,-1,-1,-1,-1,451,-1,468,-1,-1,-1,-1,377,-1,-1,-1,356,-1,373,-1,-1,-1,471,-1,488,-1,-1,-1,-1,451,-1,468,-1,-1,-1,-1,-1,-1,-1,-1,-1,-1,-1,-1,-1,125,-1,142
121,-1,-1,450,-1,467,-1,484,-1,-1,376,-1,393,-1,355,-1,372,-1,389,-1,-1,471,-1,488,-1,-1,450,-1,467,-1,484,-1,-1,376,-1,393,-1,355,-1,372,-1,389,-1,-1,-1,487,-1,504,-1,-1,450,-1,467,-1,484,-1,-1,-1,-1,-1,-1,-1,-1,-1,-1,-1,-1,110,141,-1
106,137,449,-1,466,-1,483,-1,500,375,-1,392,-1,409,-1,371,-1,388,-1,405,-1,-1,487,-1,504,449,-1,466,-1,483,-1,500,375,-1,392,-1,409,-1,371,-1,388,-1,405,-1,486,-1,503,-1,520,449,-1,466,-1,483,-1,500,-1,-1,-1,-1,-1,-1,-1,-1,-1,-1,-1,-1,126,-1
-1,122,-1,465,-1,482,-1,499,-1,516,391,-1,408,-1,425,-1,387,-1,404,-1,421,486,-1,503,-1,520,465,-1,482,-1,499,-1,516,391,-1,408,-1,425,-1,387,-1,404,-1,421,-1,502,-1,519,-1,-1,465,-1,482,-1,499,-1,516,-1,-1,-1,-1,-1,-1,-1,-1,-1,-1,125,-1,142
121,-1,-1,-1,481,-1,498,-1,515,-1,532,407,-1,424,-1,386,-1,403,-1,420,-1,-1,502,-1,519,-1,-1,481,-1,498,-1,515,-1,532,407,-1,424,-1,386,-1,403,-1,420,-1,437,-1,518,-1,535,-1,-1,481,-1,498,-1,515,-1,532,-1,-1,-1,-1,-1,-1,-1,-1,-1,110,141,-1
106,137,-1,-1,-1,497,-1,514,-1,531,-1,-1,423,-1,440,-1,-1,-1,419,-1,436,437,-1,518,-1,535,-1,-1,497,-1,514,-1,531,-1,-1,423,-1,440,-1,-1,-1,419,-1,436,-1,-1,-1,-1,-1,-1,-1,-1,497,-1,514,-1,531,-1,-1,-1,-1,-1,-1,-1,-1,-1,-1,-1,126,-1
-1,122,-1,-1,-1,-1,-1,-1,-1,-1,-1,-1,-1,-1,-1,-1,-1,-1,-1,-1,-1,-1,-1,-1,-1,-1,-1,-1,-1,-1,-1,-1,-1,-1,-1,-1,-1,-1,-1,-1,-1,-1,-1,-1,-1,-1,-1,-1,-1,-1,-1,-1,-1,-1,-1,-1,-1,-1,-1,644,-1,-1,-1,-1,-1,-1,-1,125,-1,142
121,-1,-1,-1,-1,-1,-1,-1,-1,-1,-1,-1,-1,-1,-1,-1,-1,-1,-1,-1,-1,-1,-1,-1,-1,-1,-1,-1,-1,-1,-1,-1,-1,-1,-1,-1,-1,-1,-1,-1,-1,-1,-1,-1,-1,-1,-1,-1,-1,-1,-1,-1,-1,-1,-1,-1,-1,-1,-1,-1,660,-1,-1,-1,-1,-1,-1,110,141,-1
106,137,-1,-1,-1,-1,-1,-1,-1,-1,-1,-1,-1,-1,-1,-1,-1,-1,-1,-1,-1,-1,-1,-1,-1,-1,-1,-1,-1,-1,-1,-1,-1,-1,-1,-1,-1,-1,-1,-1,-1,-1,-1,-1,-1,-1,-1,-1,-1,-1,-1,-1,-1,-1,-1,-1,-1,-1,-1,-1,-1,676,-1,-1,-1,-1,-1,-1,126,-1
643,122,-1,-1,-1,-1,-1,-1,-1,626,-1,-1,-1,-1,-1,-1,-1,-1,-1,-1,-1,-1,626,-1,-1,-1,-1,-1,626,-1,-1,-1,-1,-1,626,-1,-1,-1,-1,-1,626,-1,-1,-1,-1,-1,626,-1,-1,-1,-1,-1,-1,-1,-1,-1,-1,-1,-1,-1,-1,-1,-1,-1,-1,-1,-1,125,-1,142
121,659,-1,-1,-1,-1,-1,-1,-1,-1,642,-1,-1,-1,-1,-1,-1,-1,-1,-1,-1,-1,-1,642,-1,-1,-1,-1,-1,642,-1,-1,-1,-1,-1,642,-1,-1,-1,-1,-1,642,-1,-1,-1,-1,-1,642,-1,-1,-1,-1,-1,-1,-1,-1,-1,-1,-1,-1,-1,-1,-1,-1,-1,-1,-1,110,141,-1
106,137,675,-1,-1,-1,-1,-1,-1,-1,-1,658,-1,-1,-1,-1,-1,-1,-1,-1,-1,-1,-1,-1,658,-1,-1,-1,-1,-1,658,-1,-1,-1,-1,-1,658,-1,-1,-1,-1,-1,658,-1,-1,-1,-1,-1,658,-1,-1,-1,-1,-1,-1,-1,-1,-1,-1,-1,-1,-1,-1,-1,-1,-1,-1,-1,126,-1
-1,122,-1,-1,-1,-1,-1,-1,-1,-1,-1,-1,674,-1,-1,-1,-1,-1,-1,-1,-1,-1,-1,-1,-1,674,-1,-1,-1,-1,-1,674,-1,-1,-1,-1,-1,674,-1,-1,-1,-1,-1,674,-1,-1,-1,-1,-1,674,-1,-1,-1,-1,-1,-1,-1,-1,-1,-1,-1,-1,-1,-1,-1,-1,-1,125,-1,142
121,-1,-1,-1,-1,-1,644,-1,-1,-1,-1,-1,-1,-1,-1,-1,-1,-1,-1,-1,644,-1,-1,-1,-1,-1,-1,-1,-1,-1,-1,-1,-1,-1,-1,-1,-1,-1,-1,-1,-1,-1,-1,-1,-1,-1,-1,-1,-1,-1,-1,-1,-1,-1,-1,-1,-1,-1,-1,644,-1,-1,-1,-1,-1,-1,-1,110,141,-1
106,137,-1,-1,-1,-1,-1,660,-1,-1,-1,-1,-1,-1,-1,-1,-1,-1,-1,-1,-1,660,-1,-1,-1,-1,-1,-1,-1,-1,-1,-1,-1,-1,-1,-1,-1,-1,-1,-1,-1,-1,-1,-1,-1,-1,-1,-1,-1,-1,-1,-1,-1,-1,-1,-1,-1,-1,-1,-1,660,-1,-1,-1,-1,-1,-1,-1,126,-1
643,122,-1,-1,-1,-1,-1,-1,676,-1,-1,-1,-1,-1,-1,-1,-1,-1,-1,-1,-1,-1,676,-1,-1,-1,-1,-1,-1,-1,-1,-1,-1,-1,-1,-1,-1,-1,-1,-1,-1,-1,-1,-1,-1,-1,-1,-1,-1,-1,-1,-1,-1,-1,-1,-1,-1,-1,-1,-1,-1,676,-1,-1,-1,-1,-1,125,-1,142
121,659,-1,-1,-1,-1,-1,-1,-1,-1,-1,-1,-1,-1,-1,-1,-1,-1,-1,-1,-1,-1,-1,-1,-1,-1,-1,-1,-1,-1,-1,-1,-1,-1,-1,-1,-1,-1,-1,-1,-1,-1,-1,-1,-1,-1,-1,-1,-1,-1,-1,-1,-1,-1,-1,-1,-1,-1,-1,-1,-1,-1,-1,-1,-1,-1,-1,110,141,-1
106,137,675,-1,-1,-1,-1,-1,-1,-1,-1,-1,-1,-1,-1,-1,-1,-1,-1,-1,-1,-1,-1,-1,-1,-1,-1,-1,-1,-1,-1,-1,-1,-1,-1,-1,-1,-1,-1,-1,-1,-1,-1,-1,-1,-1,-1,-1,-1,-1,-1,-1,-1,643,-1,-1,-1,-1,-1,-1,-1,-1,-1,-1,-1,-1,-1,-1,126,-1
-1,122,-1,-1,-1,-1,-1,-1,-1,-1,-1,-1,-1,-1,643,-1,-1,-1,-1,-1,-1,-1,-1,-1,-1,-1,-1,-1,-1,-1,-1,-1,-1,-1,-1,-1,-1,-1,-1,-1,-1,-1,-1,-1,-1,-1,-1,-1,-1,-1,-1,-1,-1,-1,659,-1,-1,-1,-1,-1,-1,-1,-1,-1,-1,-1,-1,125,-1,142
121,-1,-1,-1,-1,-1,644,-1,-1,-1,-1,-1,-1,-1,-1,659,-1,-1,-1,-1,-1,-1,-1,-1,-1,-1,-1,-1,-1,-1,-1,-1,-1,-1,-1,-1,-1,-1,-1,-1,-1,-1,-1,-1,-1,-1,-1,-1,-1,-1,-1,-1,-1,-1,-1,675,-1,-1,-1,-1,-1,-1,-1,-1,-1,-1,-1,110,141,-1
106,137,-1,-1,-1,-1,-1,660,-1,-1,-1,-1,-1,-1,-1,-1,675,-1,-1,-1,-1,-1,-1,-1,-1,-1,-1,-1,-1,-1,-1,-1,-1,-1,-1,-1,-1,-1,-1,-1,-1,-1,-1,-1,-1,-1,-1,-1,-1,-1,-1,-1,-1,-1,-1,-1,-1,-1,-1,644,-1,-1,-1,-1,-1,-1,-1,-1,126,-1
643,122,-1,-1,-1,-1,-1,-1,676,-1,-1,-1,-1,-1,-1,-1,-1,-1,-1,-1,644,-1,-1,-1,-1,-1,-1,-1,-1,-1,-1,-1,-1,-1,-1,-1,-1,-1,-1,-1,-1,-1,-1,-1,-1,-1,-1,-1,-1,-1,-1,-1,-1,-1,-1,-1,-1,-1,-1,-1,660,-1,-1,-1,-1,-1,-1,125,-1,142
121,659,-1,-1,-1,-1,-1,-1,-1,-1,-1,-1,-1,-1,-1,-1,-1,-1,-1,-1,-1,660,-1,-1,-1,-1,-1,-1,-1,-1,-1,-1,-1,-1,-1,-1,-1,-1,-1,-1,-1,-1,-1,-1,-1,-1,-1,-1,-1,-1,-1,-1,-1,-1,-1,-1,-1,-1,-1,-1,-1,676,-1,-1,-1,-1,-1,110,141,-1
106,137,675,-1,-1,-1,-1,-1,-1,-1,-1,-1,-1,-1,-1,-1,-1,-1,-1,-1,-1,-1,676,-1,-1,-1,-1,-1,-1,-1,-1,-1,-1,-1,-1,-1,-1,-1,-1,-1,-1,-1,-1,-1,-1,-1,-1,-1,-1,-1,-1,-1,-1,643,-1,-1,-1,-1,-1,-1,-1,-1,-1,-1,-1,-1,-1,-1,126,-1
-1,122,-1,-1,-1,-1,-1,-1,-1,-1,-1,-1,-1,-1,643,-1,-1,-1,-1,-1,-1,-1,-1,-1,-1,-1,-1,-1,-1,-1,-1,-1,-1,-1,-1,-1,-1,-1,-1,-1,-1,-1,-1,-1,-1,-1,-1,-1,-1,-1,-1,-1,-1,-1,659,-1,-1,-1,-1,-1,-1,-1,-1,-1,-1,-1,-1,125,-1,142
121,-1,-1,-1,-1,-1,644,-1,-1,-1,-1,-1,-1,-1,-1,659,-1,-1,-1,-1,-1,-1,-1,-1,-1,-1,-1,-1,-1,-1,-1,-1,-1,-1,-1,-1,-1,-1,-1,-1,-1,-1,-1,-1,-1,-1,-1,-1,-1,-1,-1,-1,-1,-1,-1,675,-1,-1,-1,-1,-1,-1,-1,-1,-1,-1,-1,110,141,-1
106,137,-1,-1,-1,-1,-1,660,-1,-1,-1,-1,-1,-1,-1,-1,675,-1,-1,-1,-1,-1,-1,-1,-1,-1,-1,-1,-1,-1,-1,-1,-1,-1,-1,-1,-1,-1,-1,-1,-1,-1,-1,-1,-1,-1,-1,-1,-1,-1,-1,-1,-1,-1,-1,-1,-1,-1,-1,644,-1,-1,-1,-1,-1,-1,-1,-1,126,-1
643,122,-1,-1,-1,-1,-1,-1,676,-1,-1,-1,-1,-1,-1,-1,-1,-1,-1,-1,-1,-1,-1,-1,-1,-1,-1,-1,-1,-1,-1,-1,-1,-1,-1,-1,-1,-1,-1,-1,-1,-1,-1,-1,-1,-1,-1,-1,-1,-1,-1,-1,-1,-1,-1,-1,-1,-1,-1,-1,660,-1,-1,-1,-1,-1,-1,125,-1,142
121,659,-1,-1,-1,-1,-1,-1,-1,-1,-1,-1,-1,-1,-1,-1,-1,-1,-1,-1,-1,-1,-1,-1,-1,-1,-1,-1,-1,-1,-1,-1,-1,-1,-1,-1,-1,-1,-1,-1,-1,-1,-1,-1,-1,-1,-1,-1,-1,-1,-1,-1,-1,-1,-1,-1,-1,-1,-1,-1,-1,676,-1,-1,-1,-1,-1,110,141,-1
106,137,675,-1,-1,-1,-1,-1,-1,-1,-1,-1,-1,-1,-1,-1,-1,-1,-1,-1,-1,-1,-1,-1,-1,-1,-1,-1,-1,-1,-1,-1,-1,-1,-1,-1,-1,-1,-1,-1,-1,-1,-1,-1,-1,-1,-1,-1,-1,-1,-1,-1,-1,-1,-1,-1,-1,-1,-1,-1,-1,-1,-1,-1,-1,-1,-1,-1,126,-1
-1,122,-1,-1,-1,-1,-1,-1,-1,-1,-1,-1,-1,-1,-1,-1,-1,-1,-1,-1,-1,-1,-1,-1,-1,-1,-1,-1,-1,-1,-1,-1,-1,-1,-1,-1,-1,-1,-1,-1,-1,-1,-1,-1,-1,-1,-1,-1,-1,-1,-1,-1,-1,643,-1,-1,-1,-1,-1,-1,-1,-1,-1,-1,-1,-1,-1,125,-1,142
121,-1,-1,-1,-1,-1,644,-1,-1,-1,-1,-1,-1,-1,86,-1,-1,-1,-1,-1,-1,-1,-1,-1,-1,-1,-1,-1,-1,-1,-1,-1,-1,-1,-1,-1,-1,-1,-1,-1,-1,-1,-1,-1,-1,-1,-1,-1,-1,-1,-1,-1,-1,-1,659,-1,-1,-1,-1,-1,-1,-1,-1,-1,-1,-1,-1,110,141,-1
106,137,-1,-1,-1,-1,-1,660,-1,-1,-1,-1,-1,-1,86,-1,-1,-1,-1,-1,-1,-1,-1,-1,-1,-1,-1,-1,-1,-1,644,-1,-1,-1,-1,-1,-1,-1,-1,-1,-1,-1,-1,-1,-1,-1,-1,-1,-1,-1,-1,-1,-1,-1,-1,675,-1,-1,-1,-1,-1,-1,-1,-1,-1,-1,-1,-1,126,-1
643,122,-1,-1,-1,-1,-1,-1,676,-1,-1,-1,-1,-1,86,-1,-1,-1,-1,-1,-1,-1,-1,-1,-1,-1,-1,-1,-1,-1,-1,660,-1,-1,-1,-1,-1,-1,-1,-1,-1,-1,-1,-1,-1,-1,-1,-1,-1,86,-1,-1,-1,-1,86,-1,-1,-1,-1,644,-1,-1,-1,-1,-1,-1,-1,125,-1,142
121,659,-1,-1,-1,-1,-1,-1,-1,-1,-1,-1,-1,-1,86,-1,-1,-1,-1,-1,-1,-1,-1,-1,-1,-1,-1,-1,-1,29,-1,-1,676,-1,-1,-1,-1,-1,-1,-1,-1,-1,-1,-1,-1,-1,-1,-1,-1,86,-1,-1,-1,-1,86,-1,-1,-1,-1,-1,660,-1,-1,-1,-1,-1,-1,110,141,-1
106,137,675,-1,-1,-1,-1,-1,-1,-1,-1,-1,-1,-1,86,-1,-1,-1,-1,-1,-1,-1,-1,-1,-1,-1,-1,-1,-1,-1,45,-1,-1,-1,-1,-1,-1,-1,-1,-1,-1,-1,-1,-1,-1,-1,-1,-1,-1,86,-1,-1,-1,-1,86,-1,-1,-1,-1,-1,-1,676,-1,-1,-1,-1,-1,-1,126,-1
-1,122,-1,-1,-1,-1,-1,-1,-1,-1,-1,-1,-1,-1,86,-1,-1,-1,-1,-1,-1,-1,-1,-1,-1,-1,-1,-1,-1,285,-1,302,-1,-1,-1,-1,-1,-1,-1,-1,-1,-1,-1,-1,-1,-1,-1,-1,-1,86,-1,-1,-1,643,86,-1,-1,-1,-1,-1,-1,-1,-1,-1,-1,-1,-1,125,-1,142
121,-1,-1,-1,-1,-1,644,-1,-1,-1,-1,-1,-1,-1,-1,-1,-1,-1,-1,-1,-1,-1,-1,-1,-1,-1,-1,-1,284,-1,301,-1,318,-1,-1,-1,-1,-1,-1,-1,-1,-1,-1,-1,-1,-1,-1,-1,-1,86,-1,-1,-1,-1,659,-1,-1,-1,-1,-1,-1,-1,-1,-1,-1,-1,-1,110,141,-1
106,137,-1,-1,-1,-1,-1,660,-1,-1,-1,-1,-1,-1,-1,-1,-1,-1,-1,-1,-1,-1,-1,-1,-1,-1,28,-1,-1,300,-1,317,-1,334,64,-1,-1,-1,-1,-1,-1,-1,-1,-1,-1,-1,-1,-1,-1,86,-1,-1,-1,-1,86,675,-1,-1,-1,-1,-1,-1,-1,-1,-1,-1,-1,-1,126,-1
643,122,-1,-1,-1,-1,-1,-1,676,-1,-1,-1,-1,-1,-1,-1,-1,-1,-1,-1,-1,-1,-1,-1,-1,-1,-1,44,299,-1,316,-1,333,-1,-1,80,-1,-1,-1,-1,-1,-1,-1,-1,-1,-1,-1,-1,-1,86,-1,-1,-1,-1,86,-1,-1,-1,-1,-1,-1,-1,-1,-1,-1,-1,-1,125,-1,142
121,659,-1,-1,-1,-1,-1,-1,-1,-1,-1,-1,-1,-1,-1,-1,-1,-1,-1,-1,-1,-1,-1,-1,-1,-1,-1,-1,-1,315,-1,332,-1,349,-1,-1,-1,-1,-1,-1,-1,-1,-1,-1,-1,-1,-1,-1,-1,-1,174,-1,191,-1,-1,-1,-1,-1,-1,-1,-1,-1,-1,-1,-1,-1,-1,110,141,-1
106,137,675,-1,-1,-1,-1,-1,-1,-1,-1,-1,-1,-1,-1,-1,-1,-1,-1,-1,-1,-1,-1,-1,-1,-1,-1,-1,-1,-1,331,-1,348,-1,-1,-1,-1,-1,-1,-1,-1,-1,-1,-1,-1,-1,-1,-1,-1,173,-1,190,-1,207,-1,-1,-1,-1,-1,-1,-1,-1,-1,-1,-1,-1,-1,-1,126,-1
-1,122,-1,-1,-1,-1,-1,-1,-1,-1,-1,-1,-1,-1,-1,-1,-1,-1,-1,-1,-1,-1,-1,-1,-1,-1,-1,-1,-1,-1,65,-1,643,-1,-1,-1,-1,-1,-1,-1,-1,-1,-1,-1,-1,-1,-1,-1,172,-1,189,-1,206,-1,223,-1,-1,-1,-1,-1,-1,-1,-1,-1,-1,-1,-1,125,-1,142
121,-1,-1,-1,-1,-1,644,-1,-1,-1,-1,-1,-1,-1,-1,-1,-1,-1,-1,-1,-1,-1,-1,-1,-1,-1,-1,-1,-1,-1,-1,81,-1,659,-1,-1,-1,-1,-1,-1,-1,-1,-1,-1,-1,-1,-1,-1,-1,188,-1,205,-1,222,-1,-1,-1,-1,-1,-1,-1,-1,-1,-1,-1,-1,-1,110,141,-1
106,137,-1,-1,-1,-1,-1,660,-1,-1,-1,-1,-1,-1,-1,-1,-1,-1,-1,-1,-1,-1,-1,-1,-1,-1,-1,-1,-1,-1,-1,-1,-1,-1,675,-1,-1,-1,-1,-1,-1,-1,-1,-1,-1,-1,-1,-1,187,-1,204,-1,221,-1,238,-1,-1,-1,-1,-1,-1,-1,-1,-1,-1,-1,-1,-1,126,-1
643,122,-1,-1,-1,-1,-1,-1,676,-1,-1,-1,-1,-1,-1,-1,-1,-1,-1,-1,-1,-1,-1,-1,-1,-1,-1,-1,-1,-1,-1,-1,-1,-1,-1,-1,-1,-1,-1,-1,-1,-1,-1,-1,-1,-1,626,186,-1,203,626,220,-1,237,-1,254,-1,-1,-1,-1,-1,-1,-1,-1,-1,-1,-1,125,-1,142
121,659,-1,-1,-1,-1,-1,-1,-1,-1,-1,-1,-1,-1,-1,-1,-1,-1,-1,-1,-1,-1,-1,-1,-1,-1,-1,-1,-1,-1,-1,-1,-1,-1,-1,-1,-1,-1,-1,-1,-1,-1,-1,-1,-1,-1,-1,642,202,-1,219,642,-1,-1,-1,-1,-1,-1,-1,-1,-1,-1,-1,-1,-1,-1,-1,110,141,-1
106,137,675,-1,-1,-1,-1,-1,-1,-1,-1,-1,-1,-1,-1,-1,-1,-1,-1,-1,-1,-1,-1,-1,-1,-1,-1,-1,-1,-1,-1,-1,-1,-1,-1,-1,-1,-1,-1,-1,-1,-1,-1,-1,-1,-1,-1,-1,658,218,-1,235,658,-1,-1,-1,-1,-1,-1,-1,-1,-1,-1,-1,-1,-1,-1,-1,126,-1
-1,122,-1,-1,-1,-1,-1,-1,-1,-1,-1,-1,-1,-1,-1,-1,-1,-1,-1,-1,-1,-1,-1,-1,-1,-1,-1,-1,-1,-1,-1,-1,-1,-1,-1,-1,-1,-1,-1,-1,-1,-1,-1,-1,-1,-1,-1,-1,-1,674,234,-1,-1,674,-1,-1,-1,-1,-1,-1,-1,-1,-1,-1,-1,-1,-1,125,-1,142
121,-1,-1,-1,-1,-1,644,-1,-1,-1,-1,-1,-1,-1,-1,-1,-1,-1,-1,-1,-1,-1,-1,-1,-1,-1,-1,-1,-1,-1,-1,-1,-1,-1,-1,-1,-1,-1,-1,-1,-1,-1,-1,-1,-1,-1,-1,-1,-1,-1,-1,-1,-1,-1,-1,-1,-1,-1,-1,-1,-1,-1,-1,-1,-1,-1,-1,110,141,-1
106,137,-1,-1,-1,-1,-1,660,-1,-1,-1,-1,-1,-1,-1,-1,-1,-1,-1,-1,-1,-1,-1,-1,-1,-1,-1,-1,-1,-1,-1,-1,-1,-1,-1,-1,-1,-1,-1,-1,-1,-1,-1,-1,-1,-1,-1,-1,-1,-1,-1,-1,-1,-1,-1,-1,-1,-1,-1,-1,-1,-1,-1,-1,-1,-1,-1,-1,126,-1
643,122,-1,-1,-1,-1,-1,-1,676,-1,-1,-1,-1,-1,-1,-1,-1,-1,-1,-1,-1,-1,-1,-1,-1,-1,-1,-1,-1,-1,-1,-1,-1,-1,-1,-1,-1,-1,-1,-1,-1,-1,-1,-1,-1,-1,-1,-1,-1,-1,-1,-1,-1,643,-1,-1,-1,-1,-1,-1,-1,-1,-1,-1,-1,-1,-1,125,-1,142
121,659,-1,-1,-1,-1,-1,-1,-1,-1,-1,-1,-1,-1,-1,-1,-1,-1,-1,-1,-1,-1,-1,-1,-1,-1,-1,-1,-1,-1,-1,-1,-1,-1,-1,-1,-1,-1,-1,-1,-1,-1,-1,-1,-1,-1,-1,-1,-1,-1,-1,-1,-1,-1,659,-1,-1,-1,-1,-1,-1,-1,-1,-1,-1,-1,-1,110,141,-1
106,137,675,-1,-1,-1,-1,-1,-1,-1,-1,-1,-1,-1,-1,-1,-1,-1,-1,-1,-1,-1,-1,-1,-1,-1,-1,-1,-1,-1,-1,-1,-1,-1,-1,-1,-1,-1,-1,-1,-1,-1,-1,-1,-1,-1,-1,-1,-1,-1,-1,-1,-1,-1,-1,675,-1,-1,-1,-1,-1,-1,-1,-1,-1,-1,-1,-1,126,-1
-1,122,-1,-1,-1,-1,-1,-1,-1,-1,-1,-1,-1,-1,-1,-1,-1,-1,-1,-1,-1,-1,-1,-1,-1,-1,-1,-1,-1,-1,-1,-1,-1,-1,-1,-1,-1,-1,-1,-1,-1,-1,-1,-1,-1,-1,-1,-1,-1,-1,-1,-1,-1,-1,-1,-1,-1,-1,-1,-1,-1,-1,-1,-1,-1,-1,-1,125,-1,142
121,-1,-1,-1,-1,-1,644,-1,-1,-1,-1,-1,-1,-1,-1,-1,-1,-1,-1,-1,-1,-1,-1,-1,-1,-1,-1,-1,-1,-1,-1,-1,-1,-1,-1,-1,-1,-1,-1,-1,-1,-1,-1,-1,-1,-1,-1,-1,-1,-1,-1,-1,-1,-1,-1,-1,-1,-1,-1,-1,-1,-1,-1,-1,-1,-1,-1,110,141,-1
106,137,-1,-1,-1,-1,-1,660,-1,-1,-1,-1,-1,-1,-1,-1,-1,-1,-1,-1,-1,-1,-1,-1,-1,-1,-1,-1,-1,-1,-1,-1,-1,-1,-1,-1,-1,-1,-1,-1,-1,-1,-1,-1,-1,-1,-1,-1,-1,-1,-1,-1,627,-1,-1,-1,-1,-1,-1,644,-1,-1,-1,-1,-1,-1,-1,-1,126,-1
643,122,-1,-1,-1,-1,-1,-1,676,-1,-1,-1,-1,-1,-1,-1,-1,-1,-1,-1,-1,-1,-1,-1,-1,-1,-1,-1,-1,-1,-1,-1,-1,-1,-1,-1,-1,-1,-1,-1,-1,-1,-1,-1,-1,-1,-1,-1,-1,-1,-1,-1,-1,643,-1,-1,-1,-1,-1,-1,660,-1,-1,-1,-1,-1,-1,125,-1,142
121,659,-1,-1,-1,-1,-1,-1,-1,-1,-1,-1,-1,-1,-1,-1,-1,-1,-1,-1,-1,-1,-1,-1,-1,-1,-1,-1,-1,-1,-1,-1,-1,-1,-1,-1,-1,-1,-1,-1,-1,-1,-1,-1,-1,-1,-1,-1,-1,-1,-1,-1,-1,-1,659,-1,-1,-1,-1,-1,-1,676,-1,-1,-1,-1,-1,110,141,-1
106,137,675,-1,-1,-1,-1,-1,-1,-1,-1,-1,-1,-1,-1,-1,-1,-1,-1,-1,-1,-1,-1,-1,-1,-1,-1,-1,-1,-1,-1,-1,-1,-1,-1,-1,-1,-1,-1,-1,-1,-1,-1,-1,-1,-1,-1,-1,-1,-1,-1,-1,-1,-1,-1,675,-1,-1,-1,-1,-1,-1,-1,-1,-1,-1,-1,-1,126,-1
-1,122,-1,-1,-1,-1,-1,-1,-1,-1,-1,-1,-1,-1,-1,-1,-1,-1,-1,-1,-1,-1,-1,-1,-1,-1,-1,-1,-1,-1,-1,-1,-1,-1,-1,-1,-1,-1,-1,-1,-1,-1,-1,-1,-1,-1,-1,-1,-1,-1,-1,-1,-1,-1,-1,-1,-1,-1,-1,-1,-1,-1,-1,-1,-1,-1,-1,125,-1,142
121,-1,-1,-1,-1,-1,-1,-1,-1,-1,-1,-1,-1,-1,-1,-1,-1,-1,-1,-1,-1,-1,-1,-1,-1,-1,-1,-1,-1,-1,-1,-1,-1,-1,-1,-1,-1,-1,-1,-1,-1,-1,-1,-1,-1,-1,-1,-1,-1,-1,-1,-1,-1,-1,-1,-1,-1,-1,-1,-1,-1,-1,-1,-1,-1,-1,-1,110,141,-1
106,137,-1,-1,-1,-1,-1,-1,-1,-1,-1,-1,-1,-1,-1,-1,-1,-1,-1,-1,-1,-1,-1,-1,-1,-1,-1,-1,-1,-1,-1,-1,-1,-1,-1,-1,-1,-1,-1,-1,-1,-1,-1,-1,-1,-1,-1,-1,-1,-1,-1,-1,-1,-1,-1,-1,-1,-1,-1,-1,-1,-1,-1,-1,-1,-1,-1,-1,126,-1
-1,122,-1,-1,-1,-1,-1,-1,-1,-1,-1,-1,-1,-1,-1,-1,-1,-1,-1,-1,-1,-1,-1,-1,-1,-1,-1,-1,-1,-1,-1,-1,-1,-1,-1,-1,-1,-1,-1,-1,-1,-1,-1,-1,-1,-1,-1,-1,-1,-1,-1,-1,-1,-1,-1,-1,-1,-1,-1,-1,-1,-1,-1,-1,-1,-1,-1,125,-1,142
121,60,-1,77,60,-1,77,60,-1,77,60,-1,77,60,-1,77,60,-1,77,60,-1,77,60,-1,77,60,-1,77,60,-1,77,60,-1,77,60,-1,77,60,-1,77,60,-1,77,60,-1,77,60,-1,77,60,-1,77,60,-1,77,60,-1,77,60,-1,77,60,-1,77,60,-1,77,-1,141,-1
-1,137,76,-1,93,76,-1,93,76,-1,93,76,-1,93,76,-1,93,76,-1,93,76,-1,93,76,-1,93,76,-1,93,76,-1,93,76,-1,93,76,-1,93,76,-1,93,76,-1,93,76,-1,93,76,-1,93,76,-1,93,76,-1,93,76,-1,93,76,-1,93,76,-1,93,76,-1,93,-1,-1
-1,-1,-1,-1,-1,-1,-1,-1,-1,-1,-1,-1,-1,-1,-1,-1,-1,-1,-1,-1,-1,-1,-1,-1,-1,-1,-1,-1,-1,-1,-1,-1,-1,-1,-1,-1,-1,-1,-1,-1,-1,-1,-1,-1,-1,-1,-1,-1,-1,-1,-1,-1,-1,-1,-1,-1,-1,-1,-1,-1,-1,-1,-1,-1,-1,-1,-1,-1,-1,-1
